F 137,76,76
C 46,217,236

NO textures/xpm/wood.xpm
SO textures/xpm/eagle.xpm
WE textures/xpm/redbrick.xpm
EA textures/xpm/mossy.xpm

1111111111111111111
1001001001001000001
1011000001000001001
1001001000111101111
1001111000001001001
10W0000000000001001
1001111111111001001
1111000000000001011
1000000001000000001
1111111111111111111

