



SO textures/test/south.xpm

WE textures/test/west.xpm


EA textures/test/e.xpm 
   
F 4     5,  93, 2  0   
C    76,   8  7,2  5    

NO textures/test/north.xpm




        11111
     1 11111111
      110000001
       11000011
 1     111111
  111
 10001
 10001
 10001
 10001
 10001
 11001
 10001                     
 11111
 10001
 10101
 10N11   
 11111

