



SO textures/xpm/eagle.xpm




WE               textures/xpm/redbrick.xpm




EA textures/xpm/mossy.xpm












F 45,  93,                		 20   





C    76,   87,25           			   






NO                            textures/xpm/wood.xpm   


        11111
     1 11111111
      110000001
       11000011
        111111
  111
 10001
 10001
 10001
 10001
 10001
 11001
 10001                     
 11111
 10001
 10101
 10N11   
 11111











