NO textures/xpm/wood.xpm
SO textures/xpm/eagle.xpm
WE textures/xpm/redbrick.xpm
EA textures/xpm/mossy.xpm
F 220,100,0
C 225,30,0

111111
100Z01
101001
1100N1
111111
