NO textures/xpm/wood.xpm
SO textures/xpm/eagle.xpm
WE textures/xpm/redbrick.xpm
EA textures/xpm/mossy.xpm

C     128    ,     128   , 128   
F       200 ,            200  ,   200           

         111111111111111111111111
        1000000000110000000000001
        1011000001110000000000001
        1001000000000000000000001
111111111011000001110000000000001
100000000011000001110111111111111
11110111111111011100000010001
11110111111111011101010010001
11000000111111111100000010001
1000000001      1100000010001
1000000001      1101010010001
11000001111111111111011110N0111
11110111 1110101 101111010001
11111111 1111111 11111111111
